g0 g0 g0 g0 h0 g0 g1 h0 h0 h0 g0 g0 h0 h0 g0;
g1 e2 g1 h1 h0 h0 g1 g0 h0 h0 h0 h0 g0 g0 h0;
h1 d2 j1 h1 g1 g1 h0 i0 h0 h0 g0 g0 h0 h0 h0;
g1 e2 g1 h0 h1 g2 g1 h0 g0 e0 h0 G0 g0 h0 h0;
g0 g1 h1 h0 h1 j3 h2 h1 h0 h0 g1 g1 h1 h1 g1;
g1 h1 I1 j1 i1 d3 g2 g1 h2 g1 g1 h1 h1 g1 g1;
h1 g2 g1 h1 g1 g2 h1 e0 j3 h2 h1 g1 g1 h1 g1;
g2 k3 h2 h1 g1 g1 d0 h0 g4 g3 h2 h2 g2 g2 h2;
g3 g2 h2 h1 d0 h1 e0 g4 e4 g3 h2 g2 g2 h2 h2;
h2 g1 g1 h1 e0 g1 g0 h0 k1 h1 g1 g1 H1 h1 h1;
h2 h1 h1 e0 d0 d0 i1 j0 h1 j0 g1 g1 h1 g1 g1;
h1 h1 h1 e0 h0 d0 i1 h0 h0 g0 g0 h0 g0 g0 h0;
g0 g0 h1 d0 E0 d0 j1 g1 g0 h0 g0 g0 h0 g0 g0;
h0 h0 h0 i0 g0 g0 h1 g1 g0 h0 i0 i0 i0 i0 i0;
g0 g0 i0 d0 d0 h0 h1 g1 g0 g0 h0 G0 g0 h0 h0;
g0 g0 i0 d0 d0 h0 h1 g1 i0 g0 h0 h0 h0 h0 g0;
g0 h0 i0 d0 d0 h0 h1 g1 g0 h0 h0 h0 h0 g0 g0;
h0 g0 i0 d0 d0 g0 h1 g1 g0 h0 g0 g0 h0 h0 h0;
h0 h0 i0 d0 d0 h0 h1 h1 h0 h0 h0 h0 h0 h0 h0;
