h0 h0 h0 h0 h0 h0 h1 h0 h0 h0 h0 h0 h0 h0 h0;
h1 e2 h1 h1 h0 h0 h1 h0 h0 h0 h0 h0 h0 h0 h0;
h1 d2 j1 h1 h1 h1 h0 i0 h0 h0 h0 h0 h0 h0 h0;
h1 e2 h1 h0 h1 h2 h1 h0 h0 h0 h0 h0 h0 h0 h0;
h0 h1 h1 h0 h1 j3 h2 h1 h0 h0 h1 h1 h1 h1 h1;
h1 h1 i1 j1 i1 d3 h2 h1 h2 h1 h1 h1 h1 h1 h1;
h1 h2 h1 h1 h1 h2 h1 e0 j3 h2 h1 h1 h1 h1 h1;
h2 k3 h2 h1 h1 h1 d0 h0 h4 h3 h2 h2 h2 h2 h2;
h3 h2 h2 h1 d0 h1 e0 h4 e4 h3 h2 h2 h2 h2 h2;
h2 h1 h1 h1 e0 h1 h0 h0 k1 h1 h1 h1 h1 h1 h1;
h2 h1 h1 e0 d0 d0 i1 j0 h1 j0 h1 h1 h1 h1 h1;
h1 h1 h1 e0 h0 d0 i1 h0 h0 h0 h0 h0 h0 h0 h0;
h0 h0 h1 d0 E0 d0 j1 h1 h0 h0 h0 h0 h0 h0 h0;
h0 h0 h0 i0 h0 h0 h1 h1 h0 h0 i0 i0 i0 i0 i0;
h0 h0 i0 d0 d0 h0 h1 h1 h0 h0 h0 h0 h0 h0 h0;
h0 h0 i0 d0 d0 h0 h1 h1 h0 h0 h0 h0 h0 h0 h0;
h0 h0 i0 d0 d0 h0 h1 h1 h0 h0 h0 h0 h0 h0 h0;
h0 h0 i0 d0 d0 h0 h1 h1 h0 h0 h0 h0 h0 h0 h0;
h0 h0 i0 d0 d0 h0 h1 h1 h0 h0 h0 h0 h0 h0 h0;
